R 700 600

NO ./textures/text3.xpm
SO ./textures/WALL39.xpm
WE ./textures/WALL49.xpm
EA ./textures/WALL90.xpm
S ././textures/barrel.xpm

F 22,100,0
C 225,30,25


        1111111111111111111111111
        1000000000110000000000001
        1011000001110000020000001
        1001000000000000200020001
111111111011000001110000000N00001
100000000011000001110111110111111
11110111111111011100000010001
11110111111111011101010010001
110000001101010111000000100001
1000000000000000110000001000111
1000000000000000110101001000111
1100000111010100111101111000111
11110111 1110101 101111010001
11111011 1111111 111111111111